10
# # # # # # # # # #
$ . # . # . . . . #
# . # . . . # # # #
# . # . # . # . # #
# . # . # . # . # #
# . # . # . # . # #
# . . . # . . . . * 
# . # . # . # . # #
# . # . # . # . # #
# # # # # # # # # #